  11  1
1  111 11
  11A11
1  111
 11 1 11
 1  11